██████████████████████████████████████████████████████████████████████████████████████████
██      ██          ██                      ██                      ██          ██      ██
██  ██  ██  ██  ██████  ██████████████  ██  ██████████████  ██████  ██  ██  ██  ██████  ██
██  ██      ██              ██  ██      ██                  ██      ██  ██  ██          ██
██  ██████████████████████  ██  ██  ██████████████████████████  ██████  ██  ██████████  ██
██  ██              ██          ██  ██                  ██      ██      ██      ██  ██  ██
██  ██  ██████████  ██████████████  ██  ██████  ██████████  ██████████  ██████  ██  ██  ██
██  ██  ██      ██                  ██      ██              ██      ██      ██  ██  ██  ██
██████  ██  ██████████████  ██████████████  ██████████████████  ██  ██████  ██  ██  ██  ██
██      ██                  ██          ██      ██              ██      ██  ██  ██      ██
██  ██████████████  ██████████  ██████  ██████  ██████  ██████████████  ██  ██  ██████  ██
██      ██      ██      ██      ██  ██  ██      ██      ██  ██          ██  ██      ██  ██
██  ██  ██  ██  ██████████  ██████  ██  ██  ██████  ██████  ██  ██████████  ██████  ██████
██  ██      ██      ██      ██      ██  ██  ██      ██  ██      ██              ██      ██
██  ██████████████  ██  ██████████  ██  ██  ██████  ██  ██  ██████████████████████  ██  ██
██      ██          ██      ██      ██  ██          ██      ██      ██          ██  ██  ██
██████████  ██████████████  ██  ██████  ██████████████  ██████  ██  ██  ██████  ██████  ██
██          ██          ██  ██      ██  ██  ██      ██          ██      ██  ██      ██  ██
██  ██████████  ██████  ██  ██  ██  ██  ██  ██  ██  ██████████████████████  ██████  ██  ██
██  ██      ██      ██      ██  ██  ██  ██      ██                      ██          ██  ██
██  ██  ██  ██████  ██████████████  ██  ██████████  ██████████████  ██████  ██████████  ██
██  ██  ██      ██  ██              ██          ██              ██  ██      ██          ██
██  ██  ██  ██████  ██  ██████████  ██████████  ██  ██████████  ██████  ██████  ██████  ██
██  ██  ██              ██      ██      ██  ██  ██          ██      ██      ██  ██      ██
██  ██  ██████████████████  ██  ██████  ██  ██  ██████  ██████████  ██████  ██████  ██  ██
██              ██          ██      ██      ██      ██  ██      ██      ██      ██  ██  ██
██  ██████████████  ██████████████  ██████  ██████  ██████  ██  ██████  ██████  ██  ██  ██
██      ██          ██  ██          ██          ██      ██  ██      ██      ██      ██  ██
██  ██████  ██████████  ██  ██████████████████████████  ██  ██████  ██████  ██████████  ██
██  ██      ██  ██          ██              ██      ██          ██      ██      ██      ██
██  ██  ██████  ██  ██████████  ██████████  ██  ██  ██████████████  ██  ██  ██████  ██████
██  ██      ██      ██          ██      ██      ██              ██  ██  ██      ██      ██
██  ██████  ██  ██████████████  ██  ██  ██████████████████████  ██  ██  ██  ██  ██████  ██
██  ██  ██  ██              ██  ██  ██                  ██      ██  ██  ██  ██  ██      ██
██  ██  ██  ██████████████  ██  ██  ██████████████████  ██  ██████████  ██████  ██  ██████
        ██              ██      ██  ██      ██  ██      ██      ██      ██      ██  ██  ██
██████████████████████  ██████████  ██  ██  ██  ██  ██████████  ██  ██████  ██████  ██  ██
██          ██          ██      ██      ██  ██  ██  ██      ██  ██      ██          ██  ██
██████████  ██  ██████████  ██  ██████████  ██  ██  ██  ██  ██  ██████  ██  ██████████  ██
██          ██  ██      ██  ██      ██      ██  ██  ██  ██  ██      ██  ██      ██      ██
██  ██████████  ██████  ██  ██  ██████  ██████  ██  ██  ██  ██████  ██  ██████  ██  ██  ██
██      ██          ██  ██  ██          ██      ██      ██          ██  ██  ██  ██  ██    
██████  ██████████  ██  ██  ██████████████████  ██████████████████████  ██  ██  ██  ██  ██
██                  ██                                                  ██          ██  ██
██████████████████████████████████████████████████████████████████████████████████████████
